**S**************
*   *   *       *
*   *   *   *   *
*   *   *   *   *
*   *   *   *   *
*   *   *   *   *
*   *   *   *   *
*   *       *   *
*       *       *
*************G***

